soc_code,soc_title,sub_code,skill_level,sub_title,robots_1980_2000,robots_2000_2020,AI_1980_2000,AI_2000_2020,robots_all,ai_all
1115,CHIEF EXECUTIVES AND SENIOR OFFICIALS,11,Level 4,Corporate managers and directors,8856,24382,1161,18038,33238,19199
1116,ELECTED OFFICERS AND REPRESENTATIVES,11,Level 4,Corporate managers and directors,4171,5330,522,3021,9501,3543
1121,PRODUCTION MANAGERS AND DIRECTORS IN MANUFACTURING,11,Level 4,Corporate managers and directors,28445,69422,1301,15022,97867,16323
1122,PRODUCTION MANAGERS AND DIRECTORS IN CONSTRUCTION,11,Level 4,Corporate managers and directors,16258,58528,715,9828,74786,10543
1123,PRODUCTION MANAGERS AND DIRECTORS IN MINING AND ENERGY,11,Level 4,Corporate managers and directors,48788,141867,1721,21393,190655,23114
1131,FINANCIAL MANAGERS AND DIRECTORS,11,Level 4,Corporate managers and directors,2652,5910,390,6611,8562,7001
1132,MARKETING AND SALES DIRECTORS,11,Level 4,Corporate managers and directors,6275,16377,410,7625,22652,8035
1133,PURCHASING MANAGERS AND DIRECTORS,11,Level 4,Corporate managers and directors,10298,31295,853,10053,41593,10906
1134,ADVERTISING AND PUBLIC RELATIONS DIRECTORS,11,Level 4,Corporate managers and directors,10976,43100,2430,55514,54076,57944
1135,HUMAN RESOURCE MANAGERS AND DIRECTORS,11,Level 4,Corporate managers and directors,13517,26769,1331,11894,40286,13225
1136,INFORMATION TECHNOLOGY AND TELECOMMUNICATIONS DIRECTORS,11,Level 4,Corporate managers and directors,8950,49520,3125,49281,58470,52406
1139,FUNCTIONAL MANAGERS AND DIRECTORS N.E.C.,11,Level 4,Corporate managers and directors,6443,11648,577,4669,18091,5246
1150,FINANCIAL INSTITUTION MANAGERS AND DIRECTORS,11,Level 4,Corporate managers and directors,6309,6519,636,4539,12828,5175
1161,MANAGERS AND DIRECTORS IN TRANSPORT AND DISTRIBUTION,11,Level 4,Corporate managers and directors,27531,83950,1336,15560,111481,16896
1162,MANAGERS AND DIRECTORS IN STORAGE AND WAREHOUSING,11,Level 4,Corporate managers and directors,19786,48616,1013,14541,68402,15554
1171,OFFICERS IN ARMED FORCES,11,Level 4,Corporate managers and directors,3046,3443,523,1721,6489,2244
1172,SENIOR POLICE OFFICERS,11,Level 4,Corporate managers and directors,11085,24582,1141,7713,35667,8854
1173,"SENIOR OFFICERS IN FIRE, AMBULANCE, PRISON AND RELATED SERVICES",11,Level 4,Corporate managers and directors,4659,12538,204,3273,17197,3477
1181,HEALTH SERVICES AND PUBLIC HEALTH MANAGERS AND DIRECTORS,11,Level 4,Corporate managers and directors,18010,69715,1992,30279,87725,32271
1184,SOCIAL SERVICES MANAGERS AND DIRECTORS,11,Level 4,Corporate managers and directors,4580,13669,850,8846,18249,9696
1190,MANAGERS AND DIRECTORS IN RETAIL AND WHOLESALE,11,Level 4,Corporate managers and directors,23007,69151,864,15698,92158,16562
1211,MANAGERS AND PROPRIETORS IN AGRICULTURE AND HORTICULTURE,12,Level 3,Other managers and proprietors,7367,18800,1051,9607,26167,10658
1213,"MANAGERS AND PROPRIETORS IN FORESTRY, FISHING AND RELATED SERVICES",12,Level 3,Other managers and proprietors,5854,25672,702,10074,31526,10776
1221,HOTEL AND ACCOMMODATION MANAGERS AND PROPRIETORS,12,Level 3,Other managers and proprietors,14637,51098,1284,17816,65735,19100
1223,RESTAURANT AND CATERING ESTABLISHMENT MANAGERS AND PROPRIETORS,12,Level 3,Other managers and proprietors,14491,46781,1101,18273,61272,19374
1224,PUBLICANS AND MANAGERS OF LICENSED PREMISES,12,Level 3,Other managers and proprietors,9036,24015,258,5010,33051,5268
1225,LEISURE AND SPORTS MANAGERS,12,Level 3,Other managers and proprietors,4815,13877,349,3852,18692,4201
1226,TRAVEL AGENCY MANAGERS AND PROPRIETORS,12,Level 3,Other managers and proprietors,3113,7926,355,3970,11039,4325
1241,HEALTH CARE PRACTICE MANAGERS,12,Level 3,Other managers and proprietors,7036,25183,908,11978,32219,12886
1242,"RESIDENTIAL, DAY AND DOMICILIARY CARE MANAGERS AND PROPRIETORS",12,Level 3,Other managers and proprietors,17285,75090,2220,31086,92375,33306
1251,"PROPERTY, HOUSING AND ESTATE MANAGERS",12,Level 3,Other managers and proprietors,2630,11952,326,4212,14582,4538
1252,GARAGE MANAGERS AND PROPRIETORS,12,Level 3,Other managers and proprietors,49952,148800,1710,20531,198752,22241
1253,HAIRDRESSING AND BEAUTY SALON MANAGERS AND PROPRIETORS,12,Level 3,Other managers and proprietors,4146,9820,877,8365,13966,9242
1254,SHOPKEEPERS AND PROPRIETORS â€“ WHOLESALE AND RETAIL,12,Level 3,Other managers and proprietors,24348,76937,1404,30399,101285,31803
1255,WASTE DISPOSAL AND ENVIRONMENTAL SERVICES MANAGERS,12,Level 3,Other managers and proprietors,30368,118267,1776,28025,148635,29801
1259,MANAGERS AND PROPRIETORS IN OTHER SERVICES NEC,12,Level 3,Other managers and proprietors,16953,46998,1005,18705,63951,19710
2111,CHEMICAL SCIENTISTS,21,Level 4,"Science, research, engineering and technology professionals",94669,410765,6148,132148,505434,138296
2112,BIOLOGICAL SCIENTISTS AND BIOCHEMISTS,21,Level 4,"Science, research, engineering and technology professionals",41447,168390,3392,64449,209837,67841
2113,PHYSICAL SCIENTISTS,21,Level 4,"Science, research, engineering and technology professionals",41056,201743,2716,97476,242799,100192
2114,SOCIAL AND HUMANITIES SCIENTISTS,21,Level 4,"Science, research, engineering and technology professionals",5551,37964,2373,60971,43515,63344
2119,NATURAL AND SOCIAL SCIENCE PROFESSIONALS N.E.C.,21,Level 4,"Science, research, engineering and technology professionals",13939,80998,3811,83560,94937,87371
2121,CIVIL ENGINEERS,21,Level 4,"Science, research, engineering and technology professionals",55786,250544,3054,60755,306330,63809
2122,MECHANICAL ENGINEERS,21,Level 4,"Science, research, engineering and technology professionals",101214,433473,4376,95094,534687,99470
2123,ELECTRICAL ENGINEERS,21,Level 4,"Science, research, engineering and technology professionals",99426,379573,4911,62656,478999,67567
2124,ELECTRONICS ENGINEERS,21,Level 4,"Science, research, engineering and technology professionals",77725,356245,5506,100498,433970,106004
2126,DESIGN AND DEVELOPMENT ENGINEERS,21,Level 4,"Science, research, engineering and technology professionals",63985,270076,4134,87524,334061,91658
2127,PRODUCTION AND PROCESS ENGINEERS,21,Level 4,"Science, research, engineering and technology professionals",78741,279988,4567,100226,358729,104793
2129,ENGINEERING PROFESSIONALS N.E.C.,21,Level 4,"Science, research, engineering and technology professionals",66910,358246,5985,141340,425156,147325
2133,IT SPECIALIST MANAGERS,21,Level 4,"Science, research, engineering and technology professionals",26027,124821,2531,48232,150848,50763
2134,IT PROJECT AND PROGRAMME MANAGERS,21,Level 4,"Science, research, engineering and technology professionals",12212,39898,1699,27106,52110,28805
2135,"IT BUSINESS ANALYSTS, ARCHITECTS AND SYSTEMS DESIGNERS",21,Level 4,"Science, research, engineering and technology professionals",11123,87336,4545,102083,98459,106628
2136,PROGRAMMERS AND SOFTWARE DEVELOPMENT PROFESSIONALS,21,Level 4,"Science, research, engineering and technology professionals",16449,80441,3197,64398,96890,67595
2137,WEB DESIGN AND DEVELOPMENT PROFESSIONALS,21,Level 4,"Science, research, engineering and technology professionals",1786,10028,743,15392,11814,16135
2139,INFORMATION TECHNOLOGY AND TELECOMMUNICATIONS PROFESSIONALS N.E.C.,21,Level 4,"Science, research, engineering and technology professionals",31599,109839,4057,75867,141438,79924
2141,CONSERVATION PROFESSIONALS,21,Level 4,"Science, research, engineering and technology professionals",1537,13304,899,15339,14841,16238
2142,ENVIRONMENT PROFESSIONALS,21,Level 4,"Science, research, engineering and technology professionals",42733,193854,3794,93746,236587,97540
2150,RESEARCH AND DEVELOPMENT MANAGERS,21,Level 4,"Science, research, engineering and technology professionals",23270,71367,2497,37725,94637,40222
2211,MEDICAL PRACTITIONERS,22,Level 4,Health professionals,15908,73934,1790,29021,89842,30811
2212,PSYCHOLOGISTS,22,Level 4,Health professionals,19172,102817,5185,109153,121989,114338
2213,PHARMACISTS,22,Level 4,Health professionals,47770,159522,2930,59477,207292,62407
2214,OPHTHALMIC OPTICIANS,22,Level 4,Health professionals,22763,73318,2625,40674,96081,43299
2215,DENTAL PRACTITIONERS,22,Level 4,Health professionals,15902,77307,1756,29340,93209,31096
2216,VETERINARIANS,22,Level 4,Health professionals,18776,88903,1907,43984,107679,45891
2217,MEDICAL RADIOGRAPHERS,22,Level 4,Health professionals,71957,291073,5635,107715,363030,113350
2218,PODIATRISTS,22,Level 4,Health professionals,35195,180112,2736,56503,215307,59239
2219,HEALTH PROFESSIONALS N.E.C.,22,Level 4,Health professionals,20683,115541,3271,49887,136224,53158
2221,PHYSIOTHERAPISTS,22,Level 4,Health professionals,51729,207384,3813,62237,259113,66050
2222,OCCUPATIONAL THERAPISTS,22,Level 4,Health professionals,33369,149267,5555,95515,182636,101070
2223,SPEECH AND LANGUAGE THERAPISTS,22,Level 4,Health professionals,8329,45541,4310,62706,53870,67016
2229,THERAPY PROFESSIONALS N.E.C.,22,Level 4,Health professionals,37780,171532,4510,95058,209312,99568
2231,NURSES,22,Level 4,Health professionals,4847,21074,2226,15660,25921,17886
2232,MIDWIVES,22,Level 4,Health professionals,8610,27801,942,9281,36411,10223
2311,HIGHER EDUCATION TEACHING PROFESSIONALS,23,Level 4,Teaching  and educational professionals,4582,9634,637,6281,14216,6918
2315,PRIMARY AND NURSERY EDUCATION TEACHING PROFESSIONALS,23,Level 4,Teaching  and educational professionals,14371,36896,1910,25191,51267,27101
2316,SPECIAL NEEDS EDUCATION TEACHING PROFESSIONALS,23,Level 4,Teaching  and educational professionals,23499,110020,4761,72705,133519,77466
2317,SENIOR PROFESSIONALS OF EDUCATIONAL ESTABLISHMENTS,23,Level 4,Teaching  and educational professionals,14432,33961,1638,19113,48393,20751
2318,EDUCATION ADVISERS AND SCHOOL INSPECTORS,23,Level 4,Teaching  and educational professionals,10268,17335,1224,9527,27603,10751
2319,TEACHING AND OTHER EDUCATIONAL PROFESSIONALS N.E.C.,23,Level 4,Teaching  and educational professionals,38446,117047,4311,85169,155493,89480
2421,CHARTERED AND CERTIFIED ACCOUNTANTS,24,Level 4,"Business, media and public service professionals",1171,1602,125,2007,2773,2132
2423,MANAGEMENT CONSULTANTS AND BUSINESS ANALYSTS,24,Level 4,"Business, media and public service professionals",13919,52458,2979,62018,66377,64997
2424,BUSINESS AND FINANCIAL PROJECT MANAGEMENT PROFESSIONALS,24,Level 4,"Business, media and public service professionals",555,2094,149,1302,2649,1451
2425,"ACTUARIES, ECONOMISTS AND STATISTICIANS",24,Level 4,"Business, media and public service professionals",18101,132901,4334,139511,151002,143845
2426,BUSINESS AND RELATED RESEARCH PROFESSIONALS,24,Level 4,"Business, media and public service professionals",15353,70027,2436,65574,85380,68010
2429,"BUSINESS, RESEARCH AND ADMINISTRATIVE PROFESSIONALS N.E.C.",24,Level 4,"Business, media and public service professionals",6573,13747,517,6000,20320,6517
2431,ARCHITECTS,24,Level 4,"Business, media and public service professionals",2551,13198,676,10859,15749,11535
2432,TOWN PLANNING OFFICERS,24,Level 4,"Business, media and public service professionals",7346,33657,2318,37025,41003,39343
2433,QUANTITY SURVEYORS,24,Level 4,"Business, media and public service professionals",10748,32043,943,11467,42791,12410
2434,CHARTERED SURVEYORS,24,Level 4,"Business, media and public service professionals",59429,241666,3177,71669,301095,74846
2435,CHARTERED ARCHITECTURAL TECHNOLOGISTS,24,Level 4,"Business, media and public service professionals",3173,14245,343,5078,17418,5421
2436,CONSTRUCTION PROJECT MANAGERS AND RELATED PROFESSIONALS,24,Level 4,"Business, media and public service professionals",8496,26855,899,12026,35351,12925
2442,SOCIAL WORKERS,24,Level 4,"Business, media and public service professionals",3337,18398,797,14825,21735,15622
2443,PROBATION OFFICERS,24,Level 4,"Business, media and public service professionals",3043,11463,595,12335,14506,12930
2444,CLERGY,24,Level 4,"Business, media and public service professionals",523,759,136,671,1282,807
2449,WELFARE PROFESSIONALS N.E.C.,24,Level 4,"Business, media and public service professionals",1223,3465,641,4596,4688,5237
2451,LIBRARIANS,24,Level 4,"Business, media and public service professionals",14742,53728,1930,43896,68470,45826
2452,ARCHIVISTS AND CURATORS,24,Level 4,"Business, media and public service professionals",39593,145794,2532,69053,185387,71585
2461,QUALITY CONTROL AND PLANNING ENGINEERS,24,Level 4,"Business, media and public service professionals",66326,229771,3219,61452,296097,64671
2462,QUALITY ASSURANCE AND REGULATORY PROFESSIONALS,24,Level 4,"Business, media and public service professionals",78444,264736,5299,108873,343180,114172
2463,ENVIRONMENTAL HEALTH PROFESSIONALS,24,Level 4,"Business, media and public service professionals",20635,75412,1153,21597,96047,22750
2471,"JOURNALISTS, NEWSPAPER AND PERIODICAL EDITORS",24,Level 4,"Business, media and public service professionals",6231,8862,930,12708,15093,13638
2472,PUBLIC RELATIONS PROFESSIONALS,24,Level 4,"Business, media and public service professionals",1344,4125,658,7460,5469,8118
2473,ADVERTISING ACCOUNTS MANAGERS AND CREATIVE DIRECTORS,24,Level 4,"Business, media and public service professionals",7785,19836,1595,29876,27621,31471
3111,LABORATORY TECHNICIANS,31,Level 3,"Science, engineering and technology associate professionals",105101,479433,5491,126413,584534,131904
3112,ELECTRICAL AND ELECTRONICS TECHNICIANS,31,Level 3,"Science, engineering and technology associate professionals",78965,300362,4892,67951,379327,72843
3114,BUILDING AND CIVIL ENGINEERING TECHNICIANS,31,Level 3,"Science, engineering and technology associate professionals",57227,213960,2812,47864,271187,50676
3115,QUALITY ASSURANCE TECHNICIANS,31,Level 3,"Science, engineering and technology associate professionals",114462,438501,5500,98646,552963,104146
3116,"PLANNING, PROCESS AND PRODUCTION TECHNICIANS",31,Level 3,"Science, engineering and technology associate professionals",118627,459415,5885,114530,578042,120415
3119,"SCIENCE, ENGINEERING AND PRODUCTION TECHNICIANS N.E.C.",31,Level 3,"Science, engineering and technology associate professionals",116082,502956,6535,127235,619038,133770
3121,ARCHITECTURAL AND TOWN PLANNING TECHNICIANS,31,Level 3,"Science, engineering and technology associate professionals",8417,20692,786,6382,29109,7168
3122,DRAUGHTSPERSONS,31,Level 3,"Science, engineering and technology associate professionals",55045,187892,4555,78471,242937,83026
3131,IT OPERATIONS TECHNICIANS,31,Level 3,"Science, engineering and technology associate professionals",17009,69882,2054,24238,86891,26292
3132,IT USER SUPPORT TECHNICIANS,31,Level 3,"Science, engineering and technology associate professionals",51948,200360,4207,70188,252308,74395
3213,PARAMEDICS,32,Level 3,Health and social care associate professionals,33735,145202,1804,40349,178937,42153
3216,DISPENSING OPTICIANS,32,Level 3,Health and social care associate professionals,28032,84051,2558,43727,112083,46285
3217,PHARMACEUTICAL TECHNICIANS,32,Level 3,Health and social care associate professionals,25311,73176,1379,21694,98487,23073
3218,MEDICAL AND DENTAL TECHNICIANS,32,Level 3,Health and social care associate professionals,59785,282121,5678,127606,341906,133284
3219,HEALTH ASSOCIATE PROFESSIONALS N.E.C.,32,Level 3,Health and social care associate professionals,30449,118165,3608,57390,148614,60998
3231,YOUTH AND COMMUNITY WORKERS,32,Level 3,Health and social care associate professionals,1903,5013,125,1826,6916,1951
3233,CHILD AND EARLY YEARS OFFICERS,32,Level 3,Health and social care associate professionals,760,2590,568,4484,3350,5052
3234,HOUSING OFFICERS,32,Level 3,Health and social care associate professionals,5904,32730,446,10771,38634,11217
3235,COUNSELLORS,32,Level 3,Health and social care associate professionals,4506,22133,1488,41005,26639,42493
3239,WELFARE AND HOUSING ASSOCIATE PROFESSIONALS N.E.C.,32,Level 3,Health and social care associate professionals,467,3264,111,3171,3731,3282
3311,NCOs AND OTHER RANKS,33,Level 3,Protective service occupations,4218,20695,365,4653,24913,5018
3312,POLICE OFFICERS (SERGEANT AND BELOW),33,Level 3,Protective service occupations,8558,26694,459,6272,35252,6731
3313,FIRE SERVICE OFFICERS (WATCH MANAGER AND BELOW),33,Level 3,Protective service occupations,16666,48286,407,5673,64952,6080
3314,PRISON SERVICE OFFICERS (BELOW PRINCIPAL OFFICER),33,Level 3,Protective service occupations,8424,34371,519,8163,42795,8682
3315,POLICE COMMUNITY SUPPORT OFFICERS,33,Level 3,Protective service occupations,14076,42082,1034,9788,56158,10822
3319,PROTECTIVE SERVICE ASSOCIATE PROFESSIONALS N.E.C.,33,Level 3,Protective service occupations,50846,153222,2071,43365,204068,45436
3411,ARTISTS,34,Level 3,"Culture, media and sports occupations",7387,22810,1131,33872,30197,35003
3412,"AUTHORS, WRITERS AND TRANSLATORS",34,Level 3,"Culture, media and sports occupations",14241,29185,1861,32146,43426,34007
3413,"ACTORS, ENTERTAINERS AND PRESENTERS",34,Level 3,"Culture, media and sports occupations",2068,8713,808,12509,10781,13317
3414,DANCERS AND CHOREOGRAPHERS,34,Level 3,"Culture, media and sports occupations",5529,22655,480,4120,28184,4600
3415,MUSICIANS,34,Level 3,"Culture, media and sports occupations",1984,3890,565,5692,5874,6257
3416,"ARTS OFFICERS, PRODUCERS AND DIRECTORS",34,Level 3,"Culture, media and sports occupations",4474,14735,627,7129,19209,7756
3417,"PHOTOGRAPHERS, AUDIO-VISUAL AND BROADCASTING EQUIPMENT OPERATORS",34,Level 3,"Culture, media and sports occupations",92267,382099,6568,136236,474366,142804
3421,GRAPHIC DESIGNERS,34,Level 3,"Culture, media and sports occupations",5311,17455,766,14390,22766,15156
3422,"PRODUCT, CLOTHING AND RELATED DESIGNERS",34,Level 3,"Culture, media and sports occupations",17157,70245,2144,53364,87402,55508
3441,SPORTS PLAYERS,34,Level 3,"Culture, media and sports occupations",1512,12355,426,10400,13867,10826
3442,"SPORTS COACHES, INSTRUCTORS AND OFFICIALS",34,Level 3,"Culture, media and sports occupations",17580,87794,2612,49885,105374,52497
3443,FITNESS INSTRUCTORS,34,Level 3,"Culture, media and sports occupations",10777,46705,2644,30625,57482,33269
3511,AIR TRAFFIC CONTROLLERS,35,Level 3,Business and public service associate professionals,53490,203412,3299,45583,256902,48882
3512,AIRCRAFT PILOTS AND FLIGHT ENGINEERS,35,Level 3,Business and public service associate professionals,44384,132730,3454,41666,177114,45120
3513,SHIP AND HOVERCRAFT OFFICERS,35,Level 3,Business and public service associate professionals,84707,271174,2919,34022,355881,36941
3520,LEGAL ASSOCIATE PROFESSIONALS,35,Level 3,Business and public service associate professionals,634,944,178,1304,1578,1482
3531,"ESTIMATORS, VALUERS AND ASSESSORS",35,Level 3,Business and public service associate professionals,28185,110492,1893,45284,138677,47177
3532,BROKERS,35,Level 3,Business and public service associate professionals,5440,23495,749,21153,28935,21902
3533,INSURANCE UNDERWRITERS,35,Level 3,Business and public service associate professionals,1612,3698,592,6506,5310,7098
3534,FINANCE AND INVESTMENT ANALYSTS AND ADVISERS,35,Level 3,Business and public service associate professionals,2812,15914,2263,47963,18726,50226
3535,TAXATION EXPERTS,35,Level 3,Business and public service associate professionals,1165,1915,297,4811,3080,5108
3536,IMPORTERS AND EXPORTERS,35,Level 3,Business and public service associate professionals,12830,28868,717,8811,41698,9528
3537,FINANCIAL AND ACCOUNTING TECHNICIANS,35,Level 3,Business and public service associate professionals,2466,4510,252,4068,6976,4320
3538,FINANCIAL ACCOUNTS MANAGERS,35,Level 3,Business and public service associate professionals,1355,3160,149,3926,4515,4075
3539,BUSINESS AND RELATED ASSOCIATE PROFESSIONALS N.E.C.,35,Level 3,Business and public service associate professionals,24672,107470,4164,78613,132142,82777
3541,BUYERS AND PROCUREMENT OFFICERS,35,Level 3,Business and public service associate professionals,17205,47364,957,14713,64569,15670
3542,BUSINESS SALES EXECUTIVES,35,Level 3,Business and public service associate professionals,17079,61218,1071,20193,78297,21264
3543,MARKETING ASSOCIATE PROFESSIONALS,35,Level 3,Business and public service associate professionals,17067,72565,2828,77303,89632,80131
3544,ESTATE AGENTS AND AUCTIONEERS,35,Level 3,Business and public service associate professionals,4967,19021,671,14648,23988,15319
3545,SALES ACCOUNTS AND BUSINESS DEVELOPMENT MANAGERS,35,Level 3,Business and public service associate professionals,1901,6219,172,4085,8120,4257
3546,CONFERENCE AND EXHIBITION MANAGERS AND ORGANISERS,35,Level 3,Business and public service associate professionals,1776,4258,306,2776,6034,3082
3550,CONSERVATION AND ENVIRONMENTAL ASSOCIATE PROFESSIONALS,35,Level 3,Business and public service associate professionals,3716,17886,394,6688,21602,7082
3561,PUBLIC SERVICES ASSOCIATE PROFESSIONALS,35,Level 3,Business and public service associate professionals,3684,11525,353,8062,15209,8415
3562,HUMAN RESOURCES AND INDUSTRIAL RELATIONS OFFICERS,35,Level 3,Business and public service associate professionals,5986,13631,600,5907,19617,6507
3563,VOCATIONAL AND INDUSTRIAL TRAINERS AND INSTRUCTORS,35,Level 3,Business and public service associate professionals,23696,77988,2609,38239,101684,40848
3564,CAREERS ADVISERS AND VOCATIONAL GUIDANCE SPECIALISTS,35,Level 3,Business and public service associate professionals,18209,56894,3719,66522,75103,70241
3565,INSPECTORS OF STANDARDS AND REGULATIONS,35,Level 3,Business and public service associate professionals,36598,113061,1580,26447,149659,28027
3567,HEALTH AND SAFETY OFFICERS,35,Level 3,Business and public service associate professionals,32130,87027,1782,19175,119157,20957
4112,NATIONAL GOVERNMENT ADMINISTRATIVE OCCUPATIONS,41,Level 2,Administrative occupations,5777,5458,354,3388,11235,3742
4113,LOCAL GOVERNMENT ADMINISTRATIVE OCCUPATIONS,41,Level 2,Administrative occupations,8886,16791,987,14020,25677,15007
4114,OFFICERS OF NON-GOVERNMENTAL ORGANISATIONS,41,Level 2,Administrative occupations,1774,4277,157,2064,6051,2221
4121,CREDIT CONTROLLERS,41,Level 2,Administrative occupations,5640,7231,433,4441,12871,4874
4122,"BOOK-KEEPERS, PAYROLL MANAGERS AND WAGES CLERKS",41,Level 2,Administrative occupations,4738,8615,461,4662,13353,5123
4123,BANK AND POST OFFICE CLERKS,41,Level 2,Administrative occupations,3937,6560,226,2856,10497,3082
4124,FINANCE OFFICERS,41,Level 2,Administrative occupations,3389,3969,213,2524,7358,2737
4129,FINANCIAL ADMINISTRATIVE OCCUPATIONS N.E.C.,41,Level 2,Administrative occupations,320,569,24,512,889,536
4131,RECORDS CLERKS AND ASSISTANTS,41,Level 2,Administrative occupations,22771,40468,1823,20183,63239,22006
4132,PENSIONS AND INSURANCE CLERKS AND ASSISTANTS,41,Level 2,Administrative occupations,3214,6797,521,7404,10011,7925
4133,STOCK CONTROL CLERKS AND ASSISTANTS,41,Level 2,Administrative occupations,36978,88194,1636,25345,125172,26981
4134,TRANSPORT AND DISTRIBUTION CLERKS AND ASSISTANTS,41,Level 2,Administrative occupations,39777,125055,1183,22825,164832,24008
4135,LIBRARY CLERKS AND ASSISTANTS,41,Level 2,Administrative occupations,11941,32530,775,15348,44471,16123
4138,HUMAN RESOURCES ADMINISTRATIVE OCCUPATIONS,41,Level 2,Administrative occupations,14760,51405,851,11499,66165,12350
4151,SALES ADMINISTRATORS,41,Level 2,Administrative occupations,4243,5838,415,3698,10081,4113
4159,OTHER ADMINISTRATIVE OCCUPATIONS N.E.C.,41,Level 2,Administrative occupations,15421,52179,1379,26715,67600,28094
4161,OFFICE MANAGERS,41,Level 2,Administrative occupations,7660,17848,648,9016,25508,9664
4162,OFFICE SUPERVISORS,41,Level 2,Administrative occupations,8294,14841,503,3286,23135,3789
4211,MEDICAL SECRETARIES,42,Level 2,Secretarial and related occupations,5690,18099,380,7759,23789,8139
4212,LEGAL SECRETARIES,42,Level 2,Secretarial and related occupations,1577,1790,167,1306,3367,1473
4213,SCHOOL SECRETARIES,42,Level 2,Secretarial and related occupations,8344,15138,533,5844,23482,6377
4214,COMPANY SECRETARIES,42,Level 2,Secretarial and related occupations,17981,59750,885,22630,77731,23515
4215,PERSONAL ASSISTANTS AND OTHER SECRETARIES,42,Level 2,Secretarial and related occupations,15904,65723,989,32072,81627,33061
4216,RECEPTIONISTS,42,Level 2,Secretarial and related occupations,23130,68880,1682,20949,92010,22631
4217,TYPISTS AND RELATED KEYBOARD OCCUPATIONS,42,Level 2,Secretarial and related occupations,30292,68129,2687,40994,98421,43681
5111,FARMERS,51,Level 3,Skilled agricultural and related trades,13176,45554,743,11059,58730,11802
5112,HORTICULTURAL TRADES,51,Level 3,Skilled agricultural and related trades,18437,65890,1513,22251,84327,23764
5113,GARDENERS AND LANDSCAPE GARDENERS,51,Level 3,Skilled agricultural and related trades,18012,75730,998,9699,93742,10697
5114,GROUNDSMEN AND GREENKEEPERS,51,Level 3,Skilled agricultural and related trades,19555,83334,1167,15251,102889,16418
5119,AGRICULTURAL AND FISHING TRADES N.E.C.,51,Level 3,Skilled agricultural and related trades,6171,22882,1125,12733,29053,13858
5211,SMITHS AND FORGE WORKERS,52,Level 3,"Skilled metal, electrical and electronic trades",97080,335347,2718,48029,432427,50747
5212,"MOULDERS, CORE MAKERS, DIE CASTERS",52,Level 3,"Skilled metal, electrical and electronic trades",56941,197434,1660,32605,254375,34265
5213,SHEET METAL WORKERS,52,Level 3,"Skilled metal, electrical and electronic trades",74486,258448,2904,55695,332934,58599
5214,METAL PLATE WORKERS AND RIVETERS,52,Level 3,"Skilled metal, electrical and electronic trades",82182,316486,2597,64495,398668,67092
5215,WELDING TRADES,52,Level 3,"Skilled metal, electrical and electronic trades",53113,192760,1283,25735,245873,27018
5216,PIPE FITTERS,52,Level 3,"Skilled metal, electrical and electronic trades",79136,257542,3087,51597,336678,54684
5221,METAL MACHINING SETTERS AND SETTER-OPERATORS,52,Level 3,"Skilled metal, electrical and electronic trades",100144,377913,4337,73292,478057,77629
5222,"TOOL MAKERS, TOOL FITTERS AND MARKERS-OUT",52,Level 3,"Skilled metal, electrical and electronic trades",92646,341848,4416,76623,434494,81039
5223,METAL WORKING PRODUCTION AND MAINTENANCE FITTERS,52,Level 3,"Skilled metal, electrical and electronic trades",115401,479544,4375,103120,594945,107495
5224,PRECISION INSTRUMENT MAKERS AND REPAIRERS,52,Level 3,"Skilled metal, electrical and electronic trades",117355,454389,4833,95035,571744,99868
5225,AIR-CONDITIONING AND REFRIGERATION ENGINEERS,52,Level 3,"Skilled metal, electrical and electronic trades",31392,109628,1837,21755,141020,23592
5231,"VEHICLE TECHNICIANS, MECHANICS AND ELECTRICIANS",52,Level 3,"Skilled metal, electrical and electronic trades",106824,376657,4161,73316,483481,77477
5232,VEHICLE BODY BUILDERS AND REPAIRERS,52,Level 3,"Skilled metal, electrical and electronic trades",86652,349504,3702,85041,436156,88743
5234,VEHICLE PAINT TECHNICIANS,52,Level 3,"Skilled metal, electrical and electronic trades",42714,161160,2016,53674,203874,55690
5235,AIRCRAFT MAINTENANCE AND RELATED TRADES,52,Level 3,"Skilled metal, electrical and electronic trades",89606,332518,3490,64046,422124,67536
5236,BOAT AND SHIP BUILDERS AND REPAIRERS,52,Level 3,"Skilled metal, electrical and electronic trades",63655,224856,2060,38972,288511,41032
5237,RAIL AND ROLLING STOCK BUILDERS AND REPAIRERS,52,Level 3,"Skilled metal, electrical and electronic trades",64296,180919,2863,41146,245215,44009
5241,ELECTRICIANS AND ELECTRICAL FITTERS,52,Level 3,"Skilled metal, electrical and electronic trades",92532,359721,5308,91699,452253,97007
5242,TELECOMMUNICATIONS ENGINEERS,52,Level 3,"Skilled metal, electrical and electronic trades",46945,186486,3783,55520,233431,59303
5244,"TV, VIDEO AND AUDIO ENGINEERS",52,Level 3,"Skilled metal, electrical and electronic trades",107609,418001,5805,98172,525610,103977
5245,IT ENGINEERS,52,Level 3,"Skilled metal, electrical and electronic trades",78617,318154,5476,96959,396771,102435
5249,ELECTRICAL AND ELECTRONIC TRADES N.E.C.,52,Level 3,"Skilled metal, electrical and electronic trades",85149,328705,4459,65615,413854,70074
5250,"SKILLED METAL, ELECTRICAL AND ELECTRONIC TRADES SUPERVISORS",52,Level 3,"Skilled metal, electrical and electronic trades",33002,75992,1777,13777,108994,15554
5311,STEEL ERECTORS,53,Level 3,Skilled construction and building trades,47429,147006,1587,15147,194435,16734
5312,BRICKLAYERS AND MASONS,53,Level 3,Skilled construction and building trades,29730,103214,1606,36132,132944,37738
5313,"ROOFERS, ROOF TILERS AND SLATERS",53,Level 3,Skilled construction and building trades,63571,198837,3882,72456,262408,76338
5314,PLUMBERS AND HEATING AND VENTILATING ENGINEERS,53,Level 3,Skilled construction and building trades,93074,327714,3147,51627,420788,54774
5315,CARPENTERS AND JOINERS,53,Level 3,Skilled construction and building trades,35879,101476,1500,21887,137355,23387
5316,"GLAZIERS, WINDOW FABRICATORS AND FITTERS",53,Level 3,Skilled construction and building trades,53744,195947,2616,53468,249691,56084
5319,CONSTRUCTION AND BUILDING TRADES N.E.C.,53,Level 3,Skilled construction and building trades,19220,58478,694,6236,77698,6930
5321,PLASTERERS,53,Level 3,Skilled construction and building trades,50125,121622,1743,15398,171747,17141
5322,FLOORERS AND WALL TILERS,53,Level 3,Skilled construction and building trades,20898,72384,946,9528,93282,10474
5323,PAINTERS AND DECORATORS,53,Level 3,Skilled construction and building trades,60415,280608,2390,72200,341023,74590
5330,CONSTRUCTION AND BUILDING TRADES SUPERVISORS,53,Level 3,Skilled construction and building trades,18064,38030,1290,8465,56094,9755
5411,WEAVERS AND KNITTERS,54,Level 2,"Textiles, printing and other skilled trades",133120,506474,7522,151229,639594,158751
5412,UPHOLSTERERS,54,Level 2,"Textiles, printing and other skilled trades",104757,428675,5184,121901,533432,127085
5413,FOOTWEAR AND LEATHER WORKING TRADES,54,Level 2,"Textiles, printing and other skilled trades",68437,290175,2376,79870,358612,82246
5414,TAILORS AND DRESSMAKERS,54,Level 2,"Textiles, printing and other skilled trades",60297,222029,4120,89686,282326,93806
5419,"TEXTILES, GARMENTS AND RELATED TRADES N.E.C.",54,Level 2,"Textiles, printing and other skilled trades",23104,54535,1567,26427,77639,27994
5421,PRE-PRESS TECHNICIANS,54,Level 2,"Textiles, printing and other skilled trades",61365,236641,5962,138186,298006,144148
5422,PRINTERS,54,Level 2,"Textiles, printing and other skilled trades",75332,203547,3310,45158,278879,48468
5423,PRINT FINISHING AND BINDING WORKERS,54,Level 2,"Textiles, printing and other skilled trades",32927,77352,1609,25904,110279,27513
5431,BUTCHERS,54,Level 2,"Textiles, printing and other skilled trades",12993,46784,1214,25303,59777,26517
5432,BAKERS AND FLOUR CONFECTIONERS,54,Level 2,"Textiles, printing and other skilled trades",16879,38259,627,7787,55138,8414
5433,FISHMONGERS AND POULTRY DRESSERS,54,Level 2,"Textiles, printing and other skilled trades",17866,78257,1167,23817,96123,24984
5434,CHEFS,54,Level 2,"Textiles, printing and other skilled trades",34068,114939,2014,26308,149007,28322
5435,COOKS,54,Level 2,"Textiles, printing and other skilled trades",16754,55087,1079,17253,71841,18332
5436,CATERING AND BAR MANAGERS,54,Level 2,"Textiles, printing and other skilled trades",12146,39418,740,11145,51564,11885
5441,"GLASS AND CERAMICS MAKERS, DECORATORS AND FINISHERS",54,Level 2,"Textiles, printing and other skilled trades",60323,231868,3059,77866,292191,80925
5442,FURNITURE MAKERS AND OTHER CRAFT WOODWORKERS,54,Level 2,"Textiles, printing and other skilled trades",41873,138502,1732,29312,180375,31044
5443,FLORISTS,54,Level 2,"Textiles, printing and other skilled trades",5121,16499,362,7991,21620,8353
5449,OTHER SKILLED TRADES N.E.C.,54,Level 2,"Textiles, printing and other skilled trades",33044,121472,1951,46922,154516,48873
6121,NURSERY NURSES AND ASSISTANTS,61,Level 2,Caring personal service occupations,1442,3566,90,667,5008,757
6122,CHILDMINDERS AND RELATED OCCUPATIONS,61,Level 2,Caring personal service occupations,4441,7606,299,1463,12047,1762
6123,PLAYWORKER,61,Level 2,Caring personal service occupations,10612,36403,541,7526,47015,8067
6125,TEACHING ASSISTANTS,61,Level 2,Caring personal service occupations,10341,27761,1161,9636,38102,10797
6126,EDUCATIONAL SUPPORT ASSISTANTS,61,Level 2,Caring personal service occupations,19573,42588,2294,16366,62161,18660
6131,VETERINARY NURSES,61,Level 2,Caring personal service occupations,21073,116027,1474,37349,137100,38823
6132,PEST CONTROL OFFICERS,61,Level 2,Caring personal service occupations,14495,63448,484,12139,77943,12623
6139,ANIMAL CARE SERVICES OCCUPATIONS N.E.C.,61,Level 2,Caring personal service occupations,9469,37223,546,12073,46692,12619
6141,NURSING AUXILIARIES AND ASSISTANTS,61,Level 2,Caring personal service occupations,8107,28237,502,6146,36344,6648
6142,AMBULANCE STAFF (EXCLUDING PARAMEDICS),61,Level 2,Caring personal service occupations,14797,48307,684,7356,63104,8040
6143,DENTAL NURSES,61,Level 2,Caring personal service occupations,47395,175902,2522,38161,223297,40683
6144,HOUSEPARENTS AND RESIDENTIAL WARDENS,61,Level 2,Caring personal service occupations,10249,54559,1603,27730,64808,29333
6145,CARE WORKERS AND HOME CARERS,61,Level 2,Caring personal service occupations,21350,90997,1462,22973,112347,24435
6146,SENIOR CARE WORKERS,61,Level 2,Caring personal service occupations,15643,54794,895,11874,70437,12769
6147,CARE ESCORTS,61,Level 2,Caring personal service occupations,7522,22316,471,4738,29838,5209
6148,"UNDERTAKERS, MORTUARY AND CREMATORIUM ASSISTANTS",61,Level 2,Caring personal service occupations,11791,30051,648,11927,41842,12575
6211,SPORTS AND LEISURE ASSISTANTS,62,Level 2,"Leisure, travel and related personal service occupations",26071,104575,1088,26208,130646,27296
6212,TRAVEL AGENTS,62,Level 2,"Leisure, travel and related personal service occupations",956,5176,76,1451,6132,1527
6214,AIR TRAVEL ASSISTANTS,62,Level 2,"Leisure, travel and related personal service occupations",18330,60522,501,9851,78852,10352
6215,RAIL TRAVEL ASSISTANTS,62,Level 2,"Leisure, travel and related personal service occupations",60114,206459,2399,32458,266573,34857
6219,LEISURE AND TRAVEL SERVICE OCCUPATIONS N.E.C.,62,Level 2,"Leisure, travel and related personal service occupations",22512,68817,724,12965,91329,13689
6221,HAIRDRESSERS AND BARBERS,62,Level 2,"Leisure, travel and related personal service occupations",5859,17639,1018,13419,23498,14437
6222,BEAUTICIANS AND RELATED OCCUPATIONS,62,Level 2,"Leisure, travel and related personal service occupations",6878,29514,1227,30706,36392,31933
6231,HOUSEKEEPERS AND RELATED OCCUPATIONS,62,Level 2,"Leisure, travel and related personal service occupations",34263,118789,1503,20292,153052,21795
6232,CARETAKERS,62,Level 2,"Leisure, travel and related personal service occupations",26138,90722,698,7601,116860,8299
6240,CLEANING AND HOUSEKEEPING MANAGERS AND SUPERVISORS,62,Level 2,"Leisure, travel and related personal service occupations",29150,102412,868,10522,131562,11390
7111,SALES AND RETAIL ASSISTANTS,71,Level 2,Sales occupations,16201,66475,879,19342,82676,20221
7112,RETAIL CASHIERS AND CHECK-OUT OPERATORS,71,Level 2,Sales occupations,63615,207043,2816,53194,270658,56010
7113,TELEPHONE SALESPERSONS,71,Level 2,Sales occupations,22816,85959,2108,37329,108775,39437
7114,PHARMACY AND OTHER DISPENSING ASSISTANTS,71,Level 2,Sales occupations,17595,48578,803,12915,66173,13718
7115,VEHICLE AND PARTS SALESPERSONS AND ADVISERS,71,Level 2,Sales occupations,14160,70198,413,11588,84358,12001
7121,COLLECTOR SALESPERSONS AND CREDIT AGENTS,71,Level 2,Sales occupations,12905,40265,1030,17005,53170,18035
7122,"DEBT, RENT AND OTHER CASH COLLECTORS",71,Level 2,Sales occupations,32768,112301,1532,25694,145069,27226
7123,ROUNDSPERSONS AND VAN SALESPERSONS,71,Level 2,Sales occupations,20615,82079,343,12941,102694,13284
7124,MARKET AND STREET TRADERS AND ASSISTANTS,71,Level 2,Sales occupations,10703,42524,217,8421,53227,8638
7125,MERCHANDISERS AND WINDOW DRESSERS,71,Level 2,Sales occupations,48884,176607,2281,49142,225491,51423
7129,SALES RELATED OCCUPATIONS N.E.C.,71,Level 2,Sales occupations,15273,56662,1246,32351,71935,33597
7130,SALES SUPERVISORS,71,Level 2,Sales occupations,27401,91819,1893,22166,119220,24059
7211,CALL AND CONTACT CENTRE OCCUPATIONS,72,Level 2,Customer service occupations,5674,16056,1016,13355,21730,14371
7213,TELEPHONISTS,72,Level 2,Customer service occupations,25883,65215,2417,19860,91098,22277
7214,COMMUNICATION OPERATORS,72,Level 2,Customer service occupations,81283,332532,5523,92527,413815,98050
7215,MARKET RESEARCH INTERVIEWERS,72,Level 2,Customer service occupations,16688,95806,2000,83625,112494,85625
7219,CUSTOMER SERVICE OCCUPATIONS N.E.C.,72,Level 2,Customer service occupations,3433,10823,443,7940,14256,8383
7220,CUSTOMER SERVICE MANAGERS AND SUPERVISORS,72,Level 2,Customer service occupations,28331,112162,1980,36868,140493,38848
8111,"FOOD, DRINK AND TOBACCO PROCESS OPERATIVES",81,Level 2,"Process, plant and machine operatives",52838,196141,2140,61685,248979,63825
8112,GLASS AND CERAMICS PROCESS OPERATIVES,81,Level 2,"Process, plant and machine operatives",83003,237657,2583,24278,320660,26861
8113,TEXTILE PROCESS OPERATIVES,81,Level 2,"Process, plant and machine operatives",128491,444373,6319,112875,572864,119194
8114,CHEMICAL AND RELATED PROCESS OPERATIVES,81,Level 2,"Process, plant and machine operatives",75906,263910,3837,65496,339816,69333
8115,RUBBER PROCESS OPERATIVES,81,Level 2,"Process, plant and machine operatives",111149,403197,3344,53268,514346,56612
8116,PLASTICS PROCESS OPERATIVES,81,Level 2,"Process, plant and machine operatives",88296,382986,3518,75637,471282,79155
8117,METAL MAKING AND TREATING PROCESS OPERATIVES,81,Level 2,"Process, plant and machine operatives",127333,428996,3639,67722,556329,71361
8118,ELECTROPLATERS,81,Level 2,"Process, plant and machine operatives",89616,338995,3201,71338,428611,74539
8119,PROCESS OPERATIVES N.E.C.,81,Level 2,"Process, plant and machine operatives",21399,65112,1115,13943,86511,15058
8121,PAPER AND WOOD MACHINE OPERATIVES,81,Level 2,"Process, plant and machine operatives",46449,159968,951,15087,206417,16038
8122,COAL MINE OPERATIVES,81,Level 2,"Process, plant and machine operatives",112128,473161,3176,81120,585289,84296
8123,QUARRY WORKERS AND RELATED OPERATIVES,81,Level 2,"Process, plant and machine operatives",37611,139799,966,11749,177410,12715
8124,ENERGY PLANT OPERATIVES,81,Level 2,"Process, plant and machine operatives",87463,260241,3701,28830,347704,32531
8125,METAL WORKING MACHINE OPERATIVES,81,Level 2,"Process, plant and machine operatives",108692,430968,2959,60902,539660,63861
8126,WATER AND SEWERAGE PLANT OPERATIVES,81,Level 2,"Process, plant and machine operatives",56536,175250,2778,29893,231786,32671
8127,PRINTING MACHINE ASSISTANTS,81,Level 2,"Process, plant and machine operatives",116552,387174,4149,68251,503726,72400
8129,PLANT AND MACHINE OPERATIVES N.E.C.,81,Level 2,"Process, plant and machine operatives",64580,187583,1007,16396,252163,17403
8131,ASSEMBLERS (ELECTRICAL AND ELECTRONIC PRODUCTS),81,Level 2,"Process, plant and machine operatives",110822,455388,6025,100046,566210,106071
8132,ASSEMBLERS (VEHICLES AND METAL GOODS),81,Level 2,"Process, plant and machine operatives",101577,404054,4227,73428,505631,77655
8133,ROUTINE INSPECTORS AND TESTERS,81,Level 2,"Process, plant and machine operatives",110283,431845,5207,99706,542128,104913
8134,"WEIGHERS, GRADERS AND SORTERS",81,Level 2,"Process, plant and machine operatives",73388,266070,3104,87506,339458,90610
8135,"TYRE, EXHAUST AND WINDSCREEN FITTERS",81,Level 2,"Process, plant and machine operatives",80096,279360,2569,48092,359456,50661
8137,SEWING MACHINISTS,81,Level 2,"Process, plant and machine operatives",82457,347940,5057,136746,430397,141803
8139,ASSEMBLERS AND ROUTINE OPERATIVES N.E.C.,81,Level 2,"Process, plant and machine operatives",78265,280480,3654,72017,358745,75671
8141,"SCAFFOLDERS, STAGERS AND RIGGERS",81,Level 2,"Process, plant and machine operatives",37602,146939,1280,16481,184541,17761
8142,ROAD CONSTRUCTION OPERATIVES,81,Level 2,"Process, plant and machine operatives",30336,91927,815,12859,122263,13674
8143,RAIL CONSTRUCTION AND MAINTENANCE OPERATIVES,81,Level 2,"Process, plant and machine operatives",52935,134360,1667,17876,187295,19543
8149,CONSTRUCTION OPERATIVES N.E.C.,81,Level 2,"Process, plant and machine operatives",99375,389102,3988,86586,488477,90574
8211,LARGE GOODS VEHICLE DRIVERS,82,Level 1,Transport and mobile machine drivers and operatives,41573,131590,824,12105,173163,12929
8212,VAN DRIVERS,82,Level 1,Transport and mobile machine drivers and operatives,45318,142247,912,14212,187565,15124
8213,BUS AND COACH DRIVERS,82,Level 1,Transport and mobile machine drivers and operatives,59245,214355,1525,36286,273600,37811
8214,TAXI AND CAB DRIVERS AND CHAUFFEURS,82,Level 1,Transport and mobile machine drivers and operatives,38598,142828,943,17090,181426,18033
8215,DRIVING INSTRUCTORS,82,Level 1,Transport and mobile machine drivers and operatives,34167,71432,2238,19006,105599,21244
8221,CRANE DRIVERS,82,Level 1,Transport and mobile machine drivers and operatives,107482,410734,3294,36402,518216,39696
8222,FORK-LIFT TRUCK DRIVERS,82,Level 1,Transport and mobile machine drivers and operatives,44551,167072,790,8482,211623,9272
8223,AGRICULTURAL MACHINERY DRIVERS,82,Level 1,Transport and mobile machine drivers and operatives,76637,328353,3494,59243,404990,62737
8229,MOBILE MACHINE DRIVERS AND OPERATIVES N.E.C.,82,Level 1,Transport and mobile machine drivers and operatives,83997,332380,1843,34048,416377,35891
8231,TRAIN AND TRAM DRIVERS,82,Level 1,Transport and mobile machine drivers and operatives,67446,199560,2872,32977,267006,35849
8232,MARINE AND WATERWAYS TRANSPORT OPERATIVES,82,Level 1,Transport and mobile machine drivers and operatives,23404,54859,456,4069,78263,4525
8233,AIR TRANSPORT OPERATIVES,82,Level 1,Transport and mobile machine drivers and operatives,40781,172714,775,14430,213495,15205
8234,RAIL TRANSPORT OPERATIVES,82,Level 1,Transport and mobile machine drivers and operatives,70010,205506,2984,29842,275516,32826
8239,OTHER DRIVERS AND TRANSPORT OPERATIVES N.E.C.,82,Level 1,Transport and mobile machine drivers and operatives,81244,264302,2685,47298,345546,49983
9111,FARM WORKERS,91,Level 1,Elementary trades and related occupations,18754,62149,1000,14229,80903,15229
9112,FORESTRY WORKERS,91,Level 1,Elementary trades and related occupations,7467,21654,484,5080,29121,5564
9119,FISHING AND OTHER ELEMENTARY AGRICULTURE OCCUPATIONS N.E.C.,91,Level 1,Elementary trades and related occupations,3193,9607,379,4819,12800,5198
9120,ELEMENTARY CONSTRUCTION OCCUPATIONS,91,Level 1,Elementary trades and related occupations,36282,133452,1605,22644,169734,24249
9132,INDUSTRIAL CLEANING PROCESS OCCUPATIONS,91,Level 1,Elementary trades and related occupations,73181,269374,3328,58751,342555,62079
9134,"PACKERS, BOTTLERS, CANNERS AND FILLERS",91,Level 1,Elementary trades and related occupations,69829,254401,2112,47187,324230,49299
9139,ELEMENTARY PROCESS PLANT OCCUPATIONS N.E.C.,91,Level 1,Elementary trades and related occupations,63052,196892,1641,18721,259944,20362
9211,"POSTAL WORKERS, MAIL SORTERS, MESSENGERS AND COURIERS",92,Level 1,Elementary administration and service occupations,14607,38036,774,12574,52643,13348
9219,ELEMENTARY ADMINISTRATION OCCUPATIONS N.E.C.,92,Level 1,Elementary administration and service occupations,23265,57439,1473,22734,80704,24207
9231,WINDOW CLEANERS,92,Level 1,Elementary administration and service occupations,56862,267766,2867,56354,324628,59221
9232,STREET CLEANERS,92,Level 1,Elementary administration and service occupations,19124,97482,315,6463,116606,6778
9233,CLEANERS AND DOMESTICS,92,Level 1,Elementary administration and service occupations,9289,43668,292,2881,52957,3173
9234,"LAUNDERERS, DRY CLEANERS AND PRESSERS",92,Level 1,Elementary administration and service occupations,93695,357920,4009,91520,451615,95529
9235,REFUSE AND SALVAGE OCCUPATIONS,92,Level 1,Elementary administration and service occupations,41750,189641,1797,43428,231391,45225
9236,VEHICLE VALETERS AND CLEANERS,92,Level 1,Elementary administration and service occupations,33525,131760,837,20575,165285,21412
9239,ELEMENTARY CLEANING OCCUPATIONS N.E.C.,92,Level 1,Elementary administration and service occupations,21014,72964,526,10041,93978,10567
9241,SECURITY GUARDS AND RELATED OCCUPATIONS,92,Level 1,Elementary administration and service occupations,21805,77566,699,16568,99371,17267
9242,PARKING AND CIVIL ENFORCEMENT OCCUPATIONS,92,Level 1,Elementary administration and service occupations,34676,129902,1679,29716,164578,31395
9244,SCHOOL MIDDAY AND CROSSING PATROL OCCUPATIONS,92,Level 1,Elementary administration and service occupations,15991,41354,690,8572,57345,9262
9249,ELEMENTARY SECURITY OCCUPATIONS N.E.C.,92,Level 1,Elementary administration and service occupations,57189,231176,1275,33350,288365,34625
9251,SHELF FILLERS,92,Level 1,Elementary administration and service occupations,50221,171468,2112,41814,221689,43926
9259,ELEMENTARY SALES OCCUPATIONS N.E.C.,92,Level 1,Elementary administration and service occupations,18024,66711,163,7739,84735,7902
9260,ELEMENTARY STORAGE OCCUPATIONS,92,Level 1,Elementary administration and service occupations,56636,229621,764,13610,286257,14374
9271,HOSPITAL PORTERS,92,Level 1,Elementary administration and service occupations,26537,115074,615,7711,141611,8326
9272,KITCHEN AND CATERING ASSISTANTS,92,Level 1,Elementary administration and service occupations,28228,107410,856,14140,135638,14996
9273,WAITERS AND WAITRESSES,92,Level 1,Elementary administration and service occupations,7925,35233,210,5362,43158,5572
9274,BAR STAFF,92,Level 1,Elementary administration and service occupations,1917,6785,36,511,8702,547
9275,LEISURE AND THEME PARK ATTENDANTS,92,Level 1,Elementary administration and service occupations,8743,15474,172,1506,24217,1678
9279,OTHER ELEMENTARY SERVICES OCCUPATIONS N.E.C.,92,Level 1,Elementary administration and service occupations,7572,16823,186,2312,24395,2498